############################################################
#@..#...............#.#....................................#
#...#...#.#........#..#...............*....................#
###.#...#.#..##...#...#.....*..#...........................#
#....####.####*###....#.......###..........................#
#.....................#.......#.......*....................#
#...........**........#......###...........................#
#.....*.......................#............................#
#.................*...........#..*......*..................#
#......*...#...#............###............................#
#####.....#....#......#....##.###.....*....................#
#....#...#..*..##...#.#.........#..........................#
#....#*.#............#.........#...........................#
#.....##..........*...........#..*......*..................#
#......*.....#.......#.......#.............................#
#..........##.#......#..*...#.#....*.......................#
#........*#.#..*....#..........#...........................#
#........##.....................#....*.....................#
#*.........#................*....#........................g#
############################################################